LEVEL
15 15
bbbbbbbbbbbbbbb
b             b
b       a     b
b             b
b             b
b             b
b             b
b             b
b             b
b             b
b             b
b   fkm       b
b             b
b             b
bbbbbbbbbbbbbbb